1111111
1222221
1201121
1213421
1211121
1222221
1111111
